3
10 1 0,25 2 5,40 2 3,55 2 2,60 1 0,65 1 1,70 1 6,71 1 0,76 1 1,81 1 4,91 1 1
20 2 1,30 2 4,40 2 6,50 1 5,55 1 2,60 4 0,65 3 0,72 1 2,77 1 0,82 2 5,91 1 2
20 5 2,30 5 1,40 2 5,52 1 4,70 1 4,73 1 2,78 1 6,90 3 0
20 4 3,55 10 2,52 1 1,65 1 1,74 1 5,79 1 0,90 3 2
20 4 4,35 10 4,55 10 2,53 1 0,66 1 2,75 1 5,80 1 0,93 1 0