5 20
10 1 0,25 2 0,40 2 0,55 2 0,60 1 0,65 1 0,70 1 0,71 1 0,76 1 0,81 1 0,91 1 0
20 2 0,30 2 0,40 2 0,50 1 0,55 1 0,60 4 0,65 3 0,72 1 0,77 1 0,82 2 0,91 1 0
20 5 0,30 5 0,40 2 0,52 1 0,70 1 0,73 1 0,78 1 0,90 3 0
20 4 0,55 10 0,52 1 0,65 1 0,74 1 0,79 1 0,90 3 0
20 4 0,35 10 0,55 10 0,53 1 0,66 1 0,75 1 0,80 1 0,93 1 0